10 25
#########################
#                       #
#   ########            #
#                       #
#   ############        #
#   #                   #
#   #                   #
#   #####               #
#                       #
#########################
-