10 25
#########################
#                       #
#   ########            #
#                  v    #
#   ############        #
#   #                   #
#   #                   #
#   #####               #
#                       #
#########################
-